20,13,
w w w w w w w w w w w w w w w w w w w w
w p p p w p p p w p p p w p p p p w w w
w p w p w p w p w w p w w p w w w w w w
w p p p w p p p w w p w w p p p p w w w
w t w w w t w t w w t w w w w w t t p w
w p p w w p w p w w p w w w w w p w p w
w p w p w p w p w w p w w p p p p w p w
w t w t w w w t w w t w w w w t w w p w
w t w t w w w p p p t w w p w t w p p w
w p p p p w w p w w w w w p w w w p w w
w p w w p p p p p p p p p p p p p p w w
w p p p p w w w p w w w w w p w w w w w
w w w w w w w w w w w w w w w w w w w w
f,1,1;m,1,11;f,16,10;f,7,5;m,8,10
b,10;g,4;s,15;p,10;m,5;f,5;n,4;d,20
270
30