20,13,
w w w w w w w w w w w w w w w w w w w w
w p p p p w w t t t t t w w w p p p p w
w p w w p w w t w w w t w w w p w w p w
w p w w p p p p p p p p p p p p w w p w
w p p p p w p w w t w w w p w p p p p w
w w w p w w p w p p p p w p w w p w w w
w w w p t t p w p w w p w p t t p w w w
w w w p w w p w p p p p w p w w p w w w
w p p p p w p w w w t w w p w p p p p w
w p w w p w p p p p p p p p w p w w p w
w p w w p w w t w w w t w w w p w w p w
w p p p p w w t t t t t w w w p p p p w
w w w w w w w w w w w w w w w w w w w w
f,18,11;m,1,1;m,1,11;f,8,6;m,11,6
b,10;g,15;s,15;p,10;m,5;f,5;n,8;d,20
270
30