1,AlexIsFancy,2,587
2,None,2,0
3,None,2,0
4,None,2,0
5,None,2,0
6,None,2,0
7,None,2,0
8,None,2,0
9,None,2,0
10,None,2,0
